......................................#######......
......................................#.....#......
......................................#.....#......
......................................#.....#......
......................................#.....#......
......................................#.....#......
......................................#.....#......
......................................#.....#......
..............#########.........#######.....#......
......................#.........#...........#......
......................#.........#.........#########
......................#.........#.........#.#.....#
......................#.........#.....#######.....#
......................#.........#.....#...#.......#
......................#############...#...#.......#
................................#.#...#...#.......#
############^...................#########.#.......#
#.................................#...#.#.#.......#
#.................#######.........#...#####.#######
#.................#.....#.........#.....#...#......
#...............#####...#.........#######...#......
#...............#.#.#...#...................#......
#########.......#.#########.................#......
........#.......#...#...#.#.................#......
........#.......#...#...#############.......#......
........#.......#...#.....#.........#.......#......
........#.....#######.....#.........#.......#......
........#.....#.#.........#.........#.......#......
........#########.........#.........#.......#......
..............#...........#.........#.......#......
..............#.....#######.........#########......
..............#.....#..............................
..............#.....#..............................
..............#.....#..............................
..............#.....#..............................
..............#.....#..............................
..............#.....#..............................
..............#.....#..............................
..............#######..............................

path=A,B,A,B,C,C,B,A,B,C
A=L,12,L,6,L,8,R,6
B=L,8,L,8,R,4,R,6,R,6
C=L,12,R,6,L,8
